XXXXXXXXXXXXXXXXXXXXXXXXXXX
XWWWWWWWWWWWWWWWWWWWWWWWWWX
XWBFFFFFFFFFFWFFFFFFFFFFBWX
XWFWFWWFWWWWFWFWWWWFWWWWFWX
XWFWFWWFWWWWFWFWWWWFWWWWFWX
XWFFFFFFFFFFFFFFFFFFFFFFFWX
XWFWWWWFWFWWWWWWWFWFWWWWFWX
XWFFFFFFWFFFFWFFFFWFFFFFFWX
XWWWWWWFWWWWFWFWWWWFWWWWWWX
XWXXXXWFWFFFFFFFFFWFWXXXXWX
XWXXXXWFWFWWW^WWWFWFWXXXXWX
XWWWWWWFWFW0X^X1WFWFWWWWWWX
XDFFFFFFFFWXX^XXWFFFFFFFFDX
XWWWWWWFWFWXX2XXWFWFWWWWWWX
XWXXXXWFWFWWWWWWWFWFWXXXXWX
XWXXXXWFWFFFFPFFFFWFWXXXXWX
XWWWWWWFWWWWFWFWWWWFWWWWWWX
XWFFFFFFWFFFFWFFFFWFFFFFFWX
XWFWWWWFWFWWWWWWWFWFWWWWFWX
XWFFFFFFFFFFFFFFFFFFFFFFFWX
XWFWWWWFWWWWFWFWWWWFWWWWFWX
XWFWWWWFWWWWFWFWWWWFWWWWFWX
XWBFFFFFFFFFFWFFFFFFFFFFBWX
XWWWWWWWWWWWWWWWWWWWWWWWWWX
XXXXXXXXXXXXXXXXXXXXXXXXXXX